111111111111
1BPCEN10OCp1
111111111111