1111111111111111111111111111111111111111
11000B000O000000000000C111100000C1111111
1100000000000N000000N0011110000000111111
1P000000N00000111100000011C0000000011111
1100000000000011111C00001100000000001111
111111111100001111111000000000000p000111
1111111111100011111111N00N00000000000011
1111111111100011111110000000001000000011
111111100N00000C111100000N00001000000011
1111C00000N000000011000000000000N000E111
1111111111111111111111111111111111111111
