1111111111111111111111111111111111111111
1100000000000000000000C111100000C1111111
1100000000000000000000011110000000111111
1P000000000000111100000011C0000000011111
1100000000000011111C00001100000000001111
1111111111000011111110000000000000000111
1111111111100011111111000000000000000011
1111111111100011111110000000001000000011
111111100000000C111100000000001000000011
1111C00000000000001100000N00000000000111
1100000000000000000000000000000000000011
110000N0000000000C1111110000000000000001
11C0000000000000011111111C00000000000001
1111111111000011111110000000000000011111
1111111111100011111111000000000C00001111
1111111111100011111110000000001000111111
111111100000000C111100000N00001001111111
1111C0000000000000110000000000N000011111
11000000N0000000000000000000000000000111
11C0000000000000011111111C0000010000E111
1111111111111111111111111111111111111111