11111111111
1000C1P00B1
1N111101111
1000B100001
101111111N1
101p01000B1
101101N1111
10N0B1000E1
11111111111
